рассказ - story
упражнение (упражнения)- exercise
предложение - sentence

повторяем - repeat

гулять - walk
отдыхать - rest

завтракать - eat breakfast
обедать - lunch
ужинать - eat dinner

хорошо - good
плохо - bad
быстро - quick
медленно - slow
громко - loud
тихо - silent
правильно - correct
неправильно - incorrect
внимаельно - carefully
невнимательно - carelessly

рассказывать - narrate
диалог - dialogue
сейчас - now
занимается ?- engage in
готовить - prepare
смотреть - watch
немного - little, a bit
потом - then, afterwards

утром - in the morning
днем - during the days
вечером - in the evening

рано - early
поздно - late

делать - do

тоже - also
комната - room
пальто - coat
кухня - kitchen

портфель - portofolio
учебник - text book
стул - chair
шкаф - cupboard
костюм - costume
общежитие - doormatory
окно - window
картина - picture
магнитафон - record player
товарищ - comrade
тетрадь - notebook

справа - on the right
кресло - armchair
