приветствую вас - (infinitive form: приветствовать) - I greet you - greeting
читателей - (accгыфешму читатели) - whom? the readers
изданя - (preositional издание) - edition
практИчески - practically
пОлное - complete
описАние - description
практически полное описание - almost complete descritpion
систEмного програмИрования - system programming
под управлЕнием - (управление) - governed by
содержИмое - (содержание) - content
применИмо к ширОкому диапазОну - applicable to a wide range
начинАя с обИчных сЕрверов - starting from common servers
универсАльных компьЮтеров - universal computers
настольных систем - desktop systmes
закАнчивая большИм разнообрАзием встроенных устpойств - ending with a wide variaty of emedded devices
большИм разнообрАзием - wide variaty
в том числЕ работающих - including working
в том числЕ - including
под управлением операциОнной системы - governed by the operating system
на каторых в настоящее время запускается - which is currently running
в настоящее время - currently
запускается - launches

вЫшло в концЕ - came out at the end
с тогО врЕмени - since then
былО выпУщено - was released
нЕсколько обновльЕнии ядрА - multiple kernel updates
их былО примЕрно по пять за год - there were about five of them per year
несмотрЯ на то - despite
слЕдовательно - consequently
дАнного перевОда - of this translation
утрАтило актуAльности - lost its relevance
сохранИт ее еще на дОлгие годь - will keep it for many more years
тому есть две причины - there are two reasons
